...###
..##.#.####
.##..###..#
##........#
#..#@#.#...
########..#
..#..#....#
.##.##.#.##
.#......##
.#.....##
.#######