##########
#.......####
#.#.@###..##
##........##
#..#.#.#..#
########..##
#.#..#....##
#.#.##.#.##
#.......###
##.....###
#########