##########
#@.......###
#........###
######...###
#..#.#.#.##
#.##.###.###
#.#..#...###
#.#.##.#.##
#.......###
##########
#########